############
#0.........#
#.#.#.#.#.##
#..........#
##.#.#.#.#.#
#..........#
#.#.#.#.#.##
#..........#
##.#.#.#.#.#
#..........#
#.#.#.#.#1##
############
